"Plot","Quad","Species","Num.Seedlings","Num.Juveniles","Num.Dead","Total.Number","Year"
"PPW1301","B4","UMBCAL",0,1,0,1,2013
"PPW1301","B2","PSEMEN",0,1,0,1,2013
"PPW1301","C1","ARCMAN",0,1,0,1,2013
"PPW1301","D1","ARCMAN",0,1,0,1,2013
"PPW1301","D2","NOTDEN",0,0,1,0,2013
"PPW1302","A1","UMBCAL",0,2,0,2,2013
"PPW1302","A2","QUEAGR",1,0,0,1,2013
"PPW1302","A2","UMBCAL",0,2,0,2,2013
"PPW1302","A3","QUEAGR",0,11,0,11,2013
"PPW1302","A4","QUEAGR",5,6,0,11,2013
"PPW1302","B4","QUEAGR",0,17,0,17,2013
"PPW1302","B4","UMBCAL",0,2,0,2,2013
"PPW1302","B3","QUEAGR",7,7,0,14,2013
"PPW1302","B2","QUEAGR",0,4,0,4,2013
"PPW1302","B2","UMBCAL",0,1,0,1,2013
"PPW1302","B1","QUEAGR",2,2,0,4,2013
"PPW1302","B1","UMBCAL",0,1,0,1,2013
"PPW1302","B1","BACPIL",0,0,1,0,2013
"PPW1302","C4","QUEAGR",2,10,1,12,2013
"PPW1302","C3","QUEAGR",13,11,0,24,2013
"PPW1302","C3","UMBCAL",1,1,0,2,2013
"PPW1302","C2","QUEAGR",7,7,0,14,2013
"PPW1302","C2","UMBCAL",0,3,0,3,2013
"PPW1302","C1","QUEAGR",1,2,0,3,2013
"PPW1302","C1","UMBCAL",1,2,0,3,2013
"PPW1302","D4","QUEAGR",24,57,1,81,2013
"PPW1302","D3","QUEAGR",2,23,0,25,2013
"PPW1302","D2","QUEAGR",1,13,0,14,2013
"PPW1302","D2","UMBCAL",0,1,0,1,2013
"PPW1302","D1","QUEAGR",1,3,0,4,2013
"PPW1302","D1","UMBCAL",1,4,0,5,2013
"PPW1303","A1","QUEDEC",59,33,0,92,2013
"PPW1303","A1","UMBCAL",2,1,0,3,2013
"PPW1303","A2","QUEDEC",33,11,0,44,2013
"PPW1303","A2","QUEAGR",0,2,0,2,2013
"PPW1303","A3","QUEDEC",8,9,0,17,2013
"PPW1303","A3","QUEAGR",0,3,0,3,2013
"PPW1303","A3","UMBCAL",1,0,0,1,2013
"PPW1303","A4","QUEAGR",0,2,0,2,2013
"PPW1303","A4","QUEDEC",6,3,0,9,2013
"PPW1303","B1","QUEDEC",25,14,0,39,2013
"PPW1303","B1","UMBCAL",1,0,0,1,2013
"PPW1303","B1","QUEAGR",0,1,0,1,2013
"PPW1303","B2","QUEDEC",8,6,0,14,2013
"PPW1303","B3","QUEDEC",12,13,0,25,2013
"PPW1303","B3","QUEAGR",2,3,0,5,2013
"PPW1303","B3","PSEMEN",0,5,0,5,2013
"PPW1303","B3","UMBCAL",1,0,0,1,2013
"PPW1303","B4","PSEMEN",1,5,0,6,2013
"PPW1303","B4","UMBCAL",0,2,0,2,2013
"PPW1303","B4","QUEDEC",3,0,0,3,2013
"PPW1303","B4","QUEAGR",0,1,0,1,2013
"PPW1303","C1","QUEDEC",2,0,0,2,2013
"PPW1303","C2","QUEAGR",0,1,0,1,2013
"PPW1303","C2","QUEDEC",0,1,0,1,2013
"PPW1303","C3","QUEDEC",2,2,0,4,2013
"PPW1303","C3","QUEAGR",0,2,0,2,2013
"PPW1303","C3","UMBCAL",1,0,0,1,2013
"PPW1303","C4","UMBCAL",1,1,0,2,2013
"PPW1303","C4","PSEMEN",0,1,0,1,2013
"PPW1303","C4","HETARB",0,1,0,1,2013
"PPW1303","D4","QUEAGR",4,4,0,8,2013
"PPW1303","D4","UMBCAL",0,3,0,3,2013
"PPW1303","D4","QUEDEC",1,1,0,2,2013
"PPW1303","D3","QUEDEC",6,3,0,9,2013
"PPW1303","D3","QUEAGR",0,2,0,2,2013
"PPW1303","D2","QUEDEC",0,4,0,4,2013
"PPW1303","D1","QUEDEC",77,41,0,118,2013
"PPW1303","D1","QUEAGR",0,1,0,1,2013
"PPW1304","A1","QUEAGR",2,0,0,2,2013
"PPW1304","A1","QUEDEC",2,0,0,2,2013
"PPW1304","A3","QUEDEC",5,0,0,5,2013
"PPW1304","A4","QUEDEC",2,0,0,2,2013
"PPW1304","B4","QUEDEC",2,0,0,2,2013
"PPW1304","B4","QUEAGR",0,1,0,1,2013
"PPW1304","B3","QUEDEC",1,1,0,2,2013
"PPW1304","B3","HETARB",0,1,0,1,2013
"PPW1304","B2","QUEDEC",0,1,0,1,2013
"PPW1304","D4","UMBCAL",1,0,0,1,2013
"PPW1304","C1","QUEAGR",0,2,0,2,2013
"PPW1304","B3","QUEAGR",0,1,0,1,2013
"PPW1304","C3","QUEDEC",1,0,0,1,2013
"PPW1304","C4","QUEDEC",1,0,0,1,2013
"PPW1304","C4","UMBCAL",1,0,0,1,2013
"PPW1304","D3","QUEDEC",2,0,0,2,2013
"PPW1304","D2","QUEAGR",0,1,0,1,2013
"PPW1304","D2","QUEDEC",1,0,0,1,2013
"PPW1304","D1","QUEAGR",0,1,0,1,2013
"PPW1305","A1","UMBCAL",1,3,0,4,2013
"PPW1305","A2","UMBCAL",3,2,0,5,2013
"PPW1305","A3","UMBCAL",2,3,0,5,2013
"PPW1305","A3","QUEAGR",0,1,0,1,2013
"PPW1305","A4","UMBCAL",2,2,0,4,2013
"PPW1305","A4","QUEAGR",0,3,0,3,2013
"PPW1305","B4","UMBCAL",1,8,0,9,2013
"PPW1305","B4","QUEAGR",0,4,0,4,2013
"PPW1305","B3","UMBCAL",6,7,0,13,2013
"PPW1305","B3","QUEAGR",0,2,0,2,2013
"PPW1305","B3","PSEMEN",0,0,1,0,2013
"PPW1305","B2","UMBCAL",2,1,0,3,2013
"PPW1305","B1","UMBCAL",0,3,0,3,2013
"PPW1305","B1","QUEAGR",0,2,0,2,2013
"PPW1305","C1","UMBCAL",7,21,0,28,2013
"PPW1305","C1","QUEAGR",0,1,0,1,2013
"PPW1305","C2","QUEAGR",1,3,0,4,2013
"PPW1305","C2","UMBCAL",6,7,0,13,2013
"PPW1305","C3","UMBCAL",1,3,0,4,2013
"PPW1305","C4","UMBCAL",0,4,0,4,2013
"PPW1305","C4","QUEAGR",0,2,0,2,2013
"PPW1305","D4","UMBCAL",10,6,0,16,2013
"PPW1305","D4","QUEAGR",0,3,0,3,2013
"PPW1305","D3","UMBCAL",0,3,0,3,2013
"PPW1305","D3","QUEAGR",0,1,0,1,2013
"PPW1305","D2","QUEAGR",0,7,0,7,2013
"PPW1305","D2","UMBCAL",2,11,0,13,2013
"PPW1305","D2","HETARB",0,1,0,1,2013
"PPW1305","D1","QUEAGR",0,4,0,4,2013
"PPW1305","D1","UMBCAL",7,30,0,37,2013
"PPW1306","A1","UMBCAL",0,2,0,2,2013
"PPW1306","A2","UMBCAL",0,2,0,2,2013
"PPW1306","A3","ARBMEN",1,1,0,2,2013
"PPW1306","A3","UMBCAL",1,1,0,2,2013
"PPW1306","A4","PSEMEN",0,3,0,3,2013
"PPW1306","A4","ARBMEN",0,2,0,2,2013
"PPW1306","B4","UMBCAL",0,1,0,1,2013
"PPW1306","B4","ARBMEN",1,1,0,2,2013
"PPW1306","B3","ARBMEN",3,0,0,3,2013
"PPW1306","B2","PSEMEN",23,0,0,23,2013
"PPW1306","B2","UMBCAL",1,5,0,6,2013
"PPW1306","B2","QUEAGR",0,1,0,1,2013
"PPW1306","B2","PSEMEN",0,1,0,1,2013
"PPW1306","B1","ARBMEN",7,0,0,7,2013
"PPW1306","B1","UMBCAL",0,5,0,5,2013
"PPW1306","C1","UMBCAL",0,4,0,4,2013
"PPW1306","C1","ARBMEN",14,2,0,16,2013
"PPW1306","C2","ARBMEN",26,0,0,26,2013
"PPW1306","C2","PSEMEN",0,1,0,1,2013
"PPW1306","C2","UMBCAL",0,2,0,2,2013
"PPW1306","C3","ARBMEN",20,0,0,20,2013
"PPW1306","C3","PSEMEN",0,2,0,2,2013
"PPW1306","C3","UMBCAL",0,2,0,2,2013
"PPW1306","C4","UMBCAL",1,0,0,1,2013
"PPW1306","C4","ARBMEN",1,0,0,1,2013
"PPW1306","C4","PSEMEN",0,3,0,3,2013
"PPW1306","D4","ARBMEN",1,0,0,1,2013
"PPW1306","D4","UMBCAL",0,1,0,1,2013
"PPW1306","D3","ARBMEN",18,0,0,18,2013
"PPW1306","D2","ARBMEN",1,1,0,2,2013
"PPW1306","D2","UMBCAL",0,1,0,1,2013
"PPW1306","D1","ARBMEN",1,3,0,4,2013
"PPW1307","A1","UMBCAL",4,4,0,8,2013
"PPW1307","A1","QUEAGR",0,2,0,2,2013
"PPW1307","A1","ARBMEN",2,6,3,8,2013
"PPW1307","A2","UMBCAL",3,1,0,4,2013
"PPW1307","A2","QUEAGR",1,6,0,7,2013
"PPW1307","A2","PSEMEN",0,1,0,1,2013
"PPW1307","A2","BACPIL",0,1,0,1,2013
"PPW1307","A3","UMBCAL",0,1,0,1,2013
"PPW1307","A3","ARBMEN",1,14,0,15,2013
"PPW1307","A3","QUEAGR",0,1,0,1,2013
"PPW1307","A4","ARBMEN",5,11,0,16,2013
"PPW1307","A4","UMBCAL",0,8,0,8,2013
"PPW1307","A4","QUEAGR",1,1,0,2,2013
"PPW1307","B4","UMBCAL",1,1,0,2,2013
"PPW1307","B4","ARBMEN",2,9,0,11,2013
"PPW1307","B3","ARBMEN",1,2,0,3,2013
"PPW1307","B2","ARBMEN",2,0,0,2,2013
"PPW1307","B2","UMBCAL",0,2,0,2,2013
"PPW1307","B2","QUEAGR",0,1,0,1,2013
"PPW1307","B1","UMBCAL",0,2,0,2,2013
"PPW1307","B1","ARBMEN",0,0,2,0,2013
"PPW1307","B1","QUEAGR",0,3,0,3,2013
"PPW1307","C1","QUEAGR",0,3,0,3,2013
"PPW1307","C1","UMBCAL",0,3,0,3,2013
"PPW1307","C2","QUEAGR",0,2,0,2,2013
"PPW1307","C2","ARCMAN",0,1,0,1,2013
"PPW1307","C2","UMBCAL",0,2,0,2,2013
"PPW1307","C3","UMBCAL",0,3,0,3,2013
"PPW1307","C3","QUEAGR",0,2,0,2,2013
"PPW1307","C4","UMBCAL",0,4,0,4,2013
"PPW1307","C4","ARBMEN",0,4,0,4,2013
"PPW1307","D4","UMBCAL",0,4,0,4,2013
"PPW1307","D4","QUEAGR",0,3,0,3,2013
"PPW1307","D4","ARBMEN",0,5,0,5,2013
"PPW1307","D3","UMBCAL",0,7,0,7,2013
"PPW1307","D3","QUEAGR",0,2,0,2,2013
"PPW1307","D2","UMBCAL",1,4,0,5,2013
"PPW1307","D2","QUEAGR",1,5,0,6,2013
"PPW1307","D1","QUEAGR",0,1,0,1,2013
"PPW1307","D1","UMBCAL",0,2,0,2,2013
"PPW1308","A2","QUEDEC",5,1,0,6,2013
"PPW1308","B4","QUEDEC",0,0,1,0,2013
"PPW1308","B3","QUEDEC",1,0,6,1,2013
"PPW1308","B2","QUEDEC",5,5,9,10,2013
"PPW1308","D4","QUEDEC",0,0,3,0,2013
"PPW1308","D4","ARCMAN",0,1,0,1,2013
"PPW1308","D3","QUEDEC",7,0,1,7,2013
"PPW1308","D1","QUEDEC",1,0,0,1,2013
"PPW1308","D2","QUEDEC",1,0,0,1,2013
"PPW1308","B1","QUEDEC",5,4,6,9,2013
"PPW1308","C4","QUEDEC",1,2,0,3,2013
"PPW1308","C1","QUEDEC",1,4,2,5,2013
"PPW1309","A3","QUEAGR",2,1,0,3,2013
"PPW1309","A3","QUEDEC",1,1,0,2,2013
"PPW1309","A4","QUEDEC",6,0,0,6,2013
"PPW1309","D4","QUEDEC",12,2,0,14,2013
"PPW1309","D2","QUEDEC",1,0,0,1,2013
"PPW1309","C1","QUEDEC",1,0,0,1,2013
"PPW1309","C1","QUEAGR",0,1,0,1,2013
"PPW1309","C2","QUEDEC",6,0,0,6,2013
"PPW1309","C3","QUEDEC",16,1,0,17,2013
"PPW1309","B4","QUEDEC",23,5,1,28,2013
"PPW1309","B3","QUEDEC",6,2,0,8,2013
"PPW1309","C4","QUEDEC",12,0,0,12,2013
"PPW1309","B1","QUEAGR",0,1,0,1,2013
"PPW1310","A4","QUEAGR",0,1,0,1,2013
"PPW1310","B3","QUEAGR",0,1,0,1,2013
"PPW1310","B2","QUEAGR",0,2,0,2,2013
"PPW1310","B2","CEACUN",0,1,0,1,2013
"PPW1310","C1","CEACUN",1,1,0,2,2013
"PPW1310","C2","CEACUN",0,7,0,7,2013
"PPW1310","C2","QUEAGR",1,0,0,1,2013
"PPW1310","C2","ARCMAN",0,1,0,1,2013
"PPW1310","C3","CEACUN",0,1,0,1,2013
"PPW1310","C4","QUEAGR",0,1,0,1,2013
"PPW1310","D4","PSEMEN",0,1,0,1,2013
"PPW1310","D3","CEACUN",0,1,0,1,2013
"PPW1310","D1","UMBCAL",0,1,0,1,2013
"PPW1310","D1","QUEAGR",1,0,0,1,2013
"PPW1310","D1","CEACUN",2,2,0,4,2013
"PPW1310","D1","ARBMEN",1,0,0,1,2013
"PPW1310","D2","CEACUN",1,1,0,2,2013
"PPW1311","A4","HETARB",0,1,0,1,2013
"PPW1311","D4","ARCMAN",0,1,0,1,2013
"PPW1312","A1","UMBCAL",1,12,0,13,2013
"PPW1312","A1","QUEAGR",3,8,0,11,2013
"PPW1312","A1","HETARB",1,0,0,1,2013
"PPW1312","A2","UMBCAL",0,11,0,11,2013
"PPW1312","A2","QUEAGR",4,63,0,67,2013
"PPW1312","A2","ARBMEN",0,2,0,2,2013
"PPW1312","A3","QUEAGR",8,54,0,62,2013
"PPW1312","A3","UMBCAL",0,6,0,6,2013
"PPW1312","A3","HETARB",5,4,0,9,2013
"PPW1312","A4","ARBMEN",0,8,0,8,2013
"PPW1312","A4","HETARB",1,0,0,1,2013
"PPW1312","A4","PSEMEN",0,2,0,2,2013
"PPW1312","A4","QUEAGR",1,17,0,18,2013
"PPW1312","A4","UMBCAL",0,2,0,2,2013
"PPW1312","B4","UMBCAL",1,7,0,8,2013
"PPW1312","B4","QUEAGR",2,19,0,21,2013
"PPW1312","B4","ARBMEN",0,1,0,1,2013
"PPW1312","B4","PSEMEN",0,2,0,2,2013
"PPW1312","B4","HETARB",0,2,0,2,2013
"PPW1312","B3","UMBCAL",1,8,0,9,2013
"PPW1312","B3","QUEAGR",2,8,0,10,2013
"PPW1312","B3","ARBMEN",1,0,0,1,2013
"PPW1312","B2","QUEAGR",2,10,0,12,2013
"PPW1312","B2","UMBCAL",1,7,0,8,2013
"PPW1312","B2","ARBMEN",0,3,0,3,2013
"PPW1312","B1","QUEAGR",1,7,0,8,2013
"PPW1312","B1","HETARB",0,2,0,2,2013
"PPW1312","B1","UMBCAL",1,16,0,17,2013
"PPW1312","B1","ARBMEN",0,1,0,1,2013
"PPW1312","C1","UMBCAL",3,18,0,21,2013
"PPW1312","C1","QUEAGR",2,11,0,13,2013
"PPW1312","C1","HETARB",1,1,0,2,2013
"PPW1312","C1","PSEMEN",0,1,0,1,2013
"PPW1312","C2","UMBCAL",3,10,0,13,2013
"PPW1312","C2","QUEAGR",0,6,0,6,2013
"PPW1312","C2","HETARB",2,0,0,2,2013
"PPW1312","C3","UMBCAL",0,13,0,13,2013
"PPW1312","C3","QUEAGR",1,13,0,14,2013
"PPW1312","C4","UMBCAL",1,17,0,18,2013
"PPW1312","C4","QUEAGR",0,4,1,4,2013
"PPW1312","C4","HETARB",0,2,0,2,2013
"PPW1312","C4","ARBMEN",0,1,0,1,2013
"PPW1312","D4","UMBCAL",3,15,0,18,2013
"PPW1312","D4","HETARB",0,1,0,1,2013
"PPW1312","D4","QUEAGR",2,2,0,4,2013
"PPW1312","D3","UMBCAL",3,14,0,17,2013
"PPW1312","D2","UMBCAL",1,20,0,21,2013
"PPW1312","D2","QUEAGR",0,13,0,13,2013
"PPW1312","D2","HETARB",0,1,0,1,2013
"PPW1312","D1","UMBCAL",0,12,0,12,2013
"PPW1312","D1","QUEAGR",1,8,0,9,2013
"PPW1313","A1","ARBMEN",0,1,0,1,2013
"PPW1313","A1","QUEAGR",0,1,0,1,2013
"PPW1313","A1","HETARB",0,1,0,1,2013
"PPW1313","A2","ARBMEN",0,1,0,1,2013
"PPW1313","A3","QUEAGR",0,2,0,2,2013
"PPW1313","A3","ARBMEN",0,1,0,1,2013
"PPW1313","A3","UMBCAL",0,1,0,1,2013
"PPW1313","A4","ARBMEN",0,3,0,3,2013
"PPW1313","A4","HETARB",0,1,0,1,2013
"PPW1313","B4","QUEAGR",0,3,0,3,2013
"PPW1313","B4","ARBMEN",0,2,0,2,2013
"PPW1313","B3","ARBMEN",0,1,0,1,2013
"PPW1313","B3","QUEAGR",0,3,0,3,2013
"PPW1313","B3","HETARB",0,1,0,1,2013
"PPW1313","B2","QUEAGR",0,1,0,1,2013
"PPW1313","B1","UMBCAL",0,1,0,1,2013
"PPW1313","C4","HETARB",0,1,0,1,2013
"PPW1313","C4","QUEAGR",0,5,0,5,2013
"PPW1313","D4","QUEAGR",0,4,0,4,2013
"PPW1313","D4","ARBMEN",0,2,0,2,2013
"PPW1313","D4","HETARB",0,1,0,1,2013
"PPW1313","D3","ARBMEN",0,1,0,1,2013
"PPW1313","D2","HETARB",0,2,0,2,2013
"PPW1313","D1","HETARB",0,1,0,1,2013
"PPW1313","D3","HETARB",1,0,0,1,2013
"PPW1314","A3","UMBCAL",1,0,0,1,2013
"PPW1314","A4","QUEDEC",1,0,0,1,2013
"PPW1314","B4","QUEDEC",4,0,0,4,2013
"PPW1314","C3","QUEDEC",1,0,0,1,2013
"PPW1314","C1","QUEDEC",8,1,0,9,2013
"PPW1314","C3","UMBCAL",1,0,0,1,2013
"PPW1314","C4","QUEDEC",1,0,0,1,2013
"PPW1314","D1","QUEDEC",3,4,0,7,2013
"PPW1314","D2","QUEDEC",1,10,0,11,2013
"PPW1314","D4","HETARB",8,0,0,8,2013
"PPW1314","D4","QUEDEC",9,0,0,9,2013
"PPW1314","D3","QUEDEC",6,0,0,6,2013
"PPW1314","D3","HETARB",1,0,0,1,2013
"PPW1315","A1","QUEDEC",2,4,0,6,2013
"PPW1315","A1","QUEDEC",5,8,0,13,2013
"PPW1315","A2","QUEDEC",3,7,0,10,2013
"PPW1315","A2","QUEDEC",1,0,0,1,2013
"PPW1315","A2","UMBCAL",0,1,0,1,2013
"PPW1315","A3","QUEDEC",2,3,0,5,2013
"PPW1315","A3","QUEDEC",2,2,0,4,2013
"PPW1315","A4","QUEDEC",2,1,0,3,2013
"PPW1315","B4","QUEDEC",9,2,0,11,2013
"PPW1315","B4","QUEDEC",1,2,0,3,2013
"PPW1315","B4","UMBCAL",1,1,0,2,2013
"PPW1315","B3","QUEDEC",12,14,0,26,2013
"PPW1315","B3","QUEDEC",3,0,1,3,2013
"PPW1315","B2","QUEDEC",2,0,1,2,2013
"PPW1315","B2","UMBCAL",1,0,0,1,2013
"PPW1315","B2","QUEDEC",0,1,0,1,2013
"PPW1315","B1","QUEDEC",3,4,3,7,2013
"PPW1315","B1","QUEDEC",18,8,0,26,2013
"PPW1315","C1","QUEDEC",5,15,0,20,2013
"PPW1315","C1","QUEDEC",4,4,1,8,2013
"PPW1315","C1","ARBMEN",0,1,0,1,2013
"PPW1315","C2","QUEDEC",7,8,0,15,2013
"PPW1315","C2","QUEDEC",1,0,1,1,2013
"PPW1315","C3","QUEDEC",3,0,3,3,2013
"PPW1315","C3","QUEDEC",12,5,0,17,2013
"PPW1315","C4","QUEDEC",7,3,0,10,2013
"PPW1315","C4","QUEDEC",3,3,1,6,2013
"PPW1315","D4","QUEDEC",3,0,0,3,2013
"PPW1315","D4","QUEDEC",9,3,0,12,2013
"PPW1315","D1","QUEDEC",9,9,2,18,2013
"PPW1315","D1","ARBMEN",0,0,1,0,2013
"PPW1315","D1","QUEDEC",0,7,0,7,2013
"PPW1315","D1","QUEAGR",1,0,0,1,2013
"PPW1315","D2","QUEDEC",4,3,1,7,2013
"PPW1315","D2","QUEDEC",4,1,0,5,2013
"PPW1315","D2","UMBCAL",1,0,0,1,2013
"PPW1315","D3","QUEDEC",17,8,5,25,2013
"PPW1315","D3","QUEDEC",15,7,0,22,2013
"PPW1316","A1","QUEAGR",2,1,0,3,2013
"PPW1316","A1","QUEDEC",0,1,0,1,2013
"PPW1316","A2","QUEAGR",1,1,0,2,2013
"PPW1316","A2","UMBCAL",0,1,0,1,2013
"PPW1316","A3","QUEDEC",0,2,0,2,2013
"PPW1316","A3","UMBCAL",0,1,0,1,2013
"PPW1316","A3","QUEAGR",1,0,0,1,2013
"PPW1316","A4","UMBCAL",1,0,0,1,2013
"PPW1316","A4","QUEDEC",0,1,0,1,2013
"PPW1316","B4","QUEDEC",1,1,0,2,2013
"PPW1316","B4","QUEDEC",0,1,0,1,2013
"PPW1316","B4","QUEDEC",3,0,0,3,2013
"PPW1316","B2","QUEAGR",0,4,0,4,2013
"PPW1316","B2","QUEDEC",0,1,0,1,2013
"PPW1316","B2","PSEMEN",1,0,0,1,2013
"PPW1316","B1","QUEAGR",0,2,0,2,2013
"PPW1316","C2","UMBCAL",0,1,0,1,2013
"PPW1316","C3","QUEAGR",0,2,0,2,2013
"PPW1316","C4","QUEAGR",1,1,0,2,2013
"PPW1316","C4","QUEDEC",0,1,0,1,2013
"PPW1316","D4","UMBCAL",1,3,0,4,2013
"PPW1316","D4","QUEAGR",1,2,0,3,2013
"PPW1316","D3","UMBCAL",0,2,0,2,2013
"PPW1316","D1","QUEAGR",0,3,0,3,2013
"PPW1317","A1","QUEDEC",14,2,0,16,2013
"PPW1317","A1","QUEDEC",27,1,0,28,2013
"PPW1317","A2","QUEDEC",11,1,0,12,2013
"PPW1317","A2","QUEDEC",3,0,0,3,2013
"PPW1317","A2","QUEAGR",1,0,0,1,2013
"PPW1317","A3","QUEDEC",6,1,0,7,2013
"PPW1317","A3","QUEDEC",1,0,0,1,2013
"PPW1317","A3","AESCAL",0,1,0,1,2013
"PPW1317","A4","QUEDEC",9,2,0,11,2013
"PPW1317","A4","QUEDEC",1,1,0,2,2013
"PPW1317","B4","QUEDEC",1,0,0,1,2013
"PPW1317","B3","QUEDEC",3,0,0,3,2013
"PPW1317","B2","QUEDEC",6,1,0,7,2013
"PPW1317","B2","QUEDEC",1,0,0,1,2013
"PPW1317","B1","QUEDEC",7,2,0,9,2013
"PPW1317","B1","QUEDEC",32,6,0,38,2013
"PPW1317","B1","QUEAGR",1,0,0,1,2013
"PPW1317","C1","QUEDEC",5,0,0,5,2013
"PPW1317","C1","UMBCAL",1,0,0,1,2013
"PPW1317","C2","AESCAL",0,2,0,2,2013
"PPW1317","C2","QUEDEC",2,0,0,2,2013
"PPW1317","C3","QUEDEC",1,1,0,2,2013
"PPW1317","C4","QUEDEC",1,1,0,2,2013
"PPW1317","D1","QUEDEC",1,0,0,1,2013
"PPW1317","D3","AESCAL",1,1,0,2,2013
"PPW1317","D3","UMBCAL",1,1,0,2,2013
"PPW1317","D2","AESCAL",0,1,0,1,2013
"PPW1317","D2","QUEDEC",1,1,0,2,2013
"PPW1317","D2","QUEDEC",2,0,0,2,2013
"PPW1318","A1","QUEDEC",20,3,0,23,2013
"PPW1318","A2","QUEDEC",9,0,0,9,2013
"PPW1318","A3","QUEDEC",6,3,0,9,2013
"PPW1318","A4","QUEDEC",2,0,0,2,2013
"PPW1318","B1","QUEAGR",6,0,0,6,2013
"PPW1318","B1","QUEDEC",9,0,0,9,2013
"PPW1318","B2","QUEDEC",23,1,0,24,2013
"PPW1318","B2","QUEAGR",5,0,0,5,2013
"PPW1318","B3","QUEDEC",24,1,0,25,2013
"PPW1318","B3","QUEDEC",1,0,0,1,2013
"PPW1318","B4","QUEDEC",2,0,0,2,2013
"PPW1318","C4","QUEDEC",8,0,0,8,2013
"PPW1318","C4","QUEDEC",1,0,0,1,2013
"PPW1318","C4","QUEAGR",1,0,0,1,2013
"PPW1318","C4","QUEDEC",2,0,0,2,2013
"PPW1318","C3","QUEDEC",11,0,0,11,2013
"PPW1318","C3","QUEDEC",1,0,0,1,2013
"PPW1318","C2","QUEDEC",7,1,0,8,2013
"PPW1318","C2","QUEDEC",1,0,0,1,2013
"PPW1318","C1","QUEDEC",23,1,0,24,2013
"PPW1318","C1","QUEDEC",1,0,0,1,2013
"PPW1318","D1","UMBCAL",0,1,0,1,2013
"PPW1318","D1","QUEDEC",2,2,0,4,2013
"PPW1318","D1","QUEDEC",10,9,0,19,2013
"PPW1318","D2","UMBCAL",1,0,0,1,2013
"PPW1318","D3","QUEDEC",1,0,0,1,2013
"PPW1318","D4","QUEDEC",10,2,0,12,2013
"PPW1319","D1","QUEDEC",0,1,0,1,2013
"PPW1319","D3","UMBCAL",1,1,0,2,2013
"PPW1319","D4","UMBCAL",0,1,0,1,2013
"PPW1319","C1","UMBCAL",0,2,0,2,2013
"PPW1319","C4","UMBCAL",1,2,0,3,2013
"PPW1319","C4","QUEDEC",1,0,0,1,2013
"PPW1319","C4","QUEAGR",1,0,0,1,2013
"PPW1319","B3","UMBCAL",1,4,0,5,2013
"PPW1319","B3","QUEAGR",0,1,0,1,2013
"PPW1319","B4","UMBCAL",1,3,0,4,2013
"PPW1319","B4","QUEAGR",1,0,0,1,2013
"PPW1319","C2","UMBCAL",0,3,0,3,2013
"PPW1319","C2","PSEMEN",0,2,0,2,2013
"PPW1319","C2","QUEAGR",0,1,0,1,2013
"PPW1319","C1","QUEAGR",1,0,0,1,2013
"PPW1319","A3","UMBCAL",0,2,0,2,2013
"PPW1319","A3","QUEAGR",1,2,0,3,2013
"PPW1319","A3","QUEDEC",0,1,0,1,2013
"PPW1319","B2","UMBCAL",1,3,0,4,2013
"PPW1319","B2","QUEAGR",1,0,0,1,2013
"PPW1319","B1","UMBCAL",3,2,0,5,2013
"PPW1319","B1","QUEAGR",0,1,0,1,2013
"PPW1319","A2","QUEDEC",9,1,0,10,2013
"PPW1319","A2","QUEDEC",11,0,0,11,2013
"PPW1319","A2","QUEAGR",2,0,0,2,2013
"PPW1319","A2","UMBCAL",1,2,0,3,2013
"PPW1319","A1","UMBCAL",1,2,0,3,2013
"PPW1319","A1","QUEAGR",1,2,0,3,2013
"PPW1320","C4","PSEMEN",0,3,0,3,2013
"PPW1320","C4","FRACAL",1,1,0,2,2013
"PPW1320","C4","UMBCAL",0,0,0,0,2013
"PPW1320","D4","PSEMEN",1,12,0,13,2013
"PPW1320","D4","UMBCAL",0,5,0,5,2013
"PPW1320","D4","QUEAGR",0,1,0,1,2013
"PPW1320","D4","FRACAL",0,1,0,1,2013
"PPW1320","D3","HETARB",0,2,0,2,2013
"PPW1320","D3","PSEMEN",0,3,0,3,2013
"PPW1320","D3","UMBCAL",0,2,0,2,2013
"PPW1320","D3","QUEDEC",0,1,0,1,2013
"PPW1320","D2","PSEMEN",5,1,0,6,2013
"PPW1320","D2","QUEAGR",0,1,0,1,2013
"PPW1320","D2","UMBCAL",0,1,0,1,2013
"PPW1320","D1","UMBCAL",1,1,0,2,2013
"PPW1320","D1","PSEMEN",0,2,0,2,2013
"PPW1320","D1","FRACAL",0,2,0,2,2013
"PPW1320","A1","UMBCAL",0,1,0,1,2013
"PPW1320","A1","FRACAL",5,2,0,7,2013
"PPW1320","A1","QUEAGR",0,1,0,1,2013
"PPW1320","A2","PSEMEN",0,1,0,1,2013
"PPW1320","A2","UMBCAL",0,2,0,2,2013
"PPW1320","A2","QUEAGR",0,3,0,3,2013
"PPW1320","A3","FRACAL",0,3,0,3,2013
"PPW1320","A3","UMBCAL",0,3,0,3,2013
"PPW1320","A4","FRACAL",0,2,0,2,2013
"PPW1320","B4","FRACAL",0,1,0,1,2013
"PPW1320","B4","UMBCAL",0,1,0,1,2013
"PPW1320","B3","UMBCAL",0,2,0,2,2013
"PPW1320","B3","FRACAL",0,6,0,6,2013
"PPW1320","B3","PSEMEN",0,3,0,3,2013
"PPW1320","B2","FRACAL",0,1,0,1,2013
"PPW1320","B2","PSEMEN",0,3,0,3,2013
"PPW1320","B2","UMBCAL",0,1,0,1,2013
"PPW1320","B1","UMBCAL",0,2,0,2,2013
"PPW1320","B1","HETARB",0,1,0,1,2013
"PPW1320","C1","UMBCAL",0,7,0,7,2013
"PPW1320","C1","PSEMEN",0,3,0,3,2013
"PPW1320","C1","FRACAL",0,1,0,1,2013
"PPW1320","C2","PSEMEN",1,2,0,3,2013
"PPW1320","C2","UMBCAL",1,3,0,4,2013
"PPW1320","C2","FRACAL",0,1,0,1,2013
"PPW1320","C2","QUEAGR",0,2,0,2,2013
"PPW1320","C2","HETARB",0,1,0,1,2013
"PPW1320","C3","PSEMEN",0,5,0,5,2013
"PPW1320","C3","HETARB",0,1,0,1,2013
"PPW1320","C3","UMBCAL",1,1,0,2,2013
"PPW1321","A1","UMBCAL",0,3,0,3,2013
"PPW1321","A1","FRACAL",0,1,0,1,2013
"PPW1321","A2","UMBCAL",0,3,0,3,2013
"PPW1321","A2","FRACAL",0,2,0,2,2013
"PPW1321","A3","UMBCAL",0,4,0,4,2013
"PPW1321","A3","FRACAL",0,6,0,6,2013
"PPW1321","A3","QUEAGR",0,2,0,2,2013
"PPW1321","A4","UMBCAL",0,10,0,10,2013
"PPW1321","A4","QUEAGR",0,4,0,4,2013
"PPW1321","A4","FRACAL",0,6,0,6,2013
"PPW1321","A4","ARBMEN",0,1,0,1,2013
"PPW1321","B4","FRACAL",0,13,0,13,2013
"PPW1321","B4","UMBCAL",0,10,0,10,2013
"PPW1321","B4","QUEAGR",0,2,0,2,2013
"PPW1321","B3","UMBCAL",1,14,0,15,2013
"PPW1321","B3","FRACAL",0,8,0,8,2013
"PPW1321","B3","ARBMEN",1,5,0,6,2013
"PPW1321","B3","QUEAGR",0,1,0,1,2013
"PPW1321","B3","HETARB",0,1,0,1,2013
"PPW1321","B2","UMBCAL",0,3,0,3,2013
"PPW1321","B2","FRACAL",0,2,0,2,2013
"PPW1321","B1","UMBCAL",0,7,0,7,2013
"PPW1321","B1","FRACAL",0,2,0,2,2013
"PPW1321","C1","FRACAL",0,1,0,1,2013
"PPW1321","C1","UMBCAL",0,1,0,1,2013
"PPW1321","C2","FRACAL",0,5,0,5,2013
"PPW1321","C2","UMBCAL",0,5,0,5,2013
"PPW1321","C3","FRACAL",0,5,0,5,2013
"PPW1321","C3","UMBCAL",0,5,0,5,2013
"PPW1321","C3","QUEAGR",0,1,0,1,2013
"PPW1321","C4","FRACAL",0,3,0,3,2013
"PPW1321","C4","UMBCAL",0,5,0,5,2013
"PPW1321","D4","UMBCAL",0,6,0,6,2013
"PPW1321","D4","FRACAL",0,1,0,1,2013
"PPW1321","D3","UMBCAL",0,10,0,10,2013
"PPW1321","D3","FRACAL",0,2,0,2,2013
"PPW1321","D3","QUEAGR",0,1,0,1,2013
"PPW1321","D2","UMBCAL",0,8,0,8,2013
"PPW1321","D2","FRACAL",0,4,0,4,2013
"PPW1321","D2","QUEAGR",0,2,0,2,2013
"PPW1321","D1","FRACAL",0,3,0,3,2013
"PPW1321","D1","UMBCAL",0,1,0,1,2013
"PPW1322","A1","QUEAGR",0,1,0,1,2013
"PPW1322","A2","QUEAGR",0,3,0,3,2013
"PPW1322","A3","QUEAGR",0,5,0,5,2013
"PPW1322","B3","QUEAGR",1,3,0,4,2013
"PPW1322","B3","QUEDEC",0,1,0,1,2013
"PPW1322","B2","QUEAGR",1,3,1,4,2013
"PPW1322","B1","QUEAGR",0,2,0,2,2013
"PPW1322","C2","QUEAGR",0,1,0,1,2013
"PPW1322","C4","QUEAGR",0,2,0,2,2013
"PPW1322","D4","QUEAGR",0,7,0,7,2013
"PPW1322","D3","QUEAGR",0,1,0,1,2013
"PPW1322","D2","QUEAGR",0,1,0,1,2013
"PPW1322","C2","QUEDEC",0,1,0,1,2013
"PPW1323","A1","QUEDEC",2,0,0,2,2013
"PPW1323","A4","QUEDEC",1,0,0,1,2013
"PPW1323","B3","QUEAGR",0,1,0,1,2013
"PPW1323","C1","QUEDEC",8,0,0,8,2013
"PPW1323","D1","QUEDEC",2,0,0,2,2013
"PPW1323","D1","QUEAGR",1,0,0,1,2013
"PPW1323","D2","QUEDEC",1,0,0,1,2013
"PPW1323","D4","QUEDEC",7,0,0,7,2013
"PPW1323","C2","QUEDEC",1,0,0,1,2013
"PPW1323","C4","QUEDEC",2,0,0,2,2013
"PPW1324","A1","UMBCAL",0,1,0,1,2013
"PPW1324","A1","QUEDEC",0,1,0,1,2013
"PPW1324","A2","QUEDEC",1,0,0,1,2013
"PPW1324","A3","UMBCAL",0,1,0,1,2013
"PPW1324","A4","ARBMEN",1,1,0,2,2013
"PPW1324","B4","QUEDEC",1,0,0,1,2013
"PPW1324","B3","QUEDEC",14,19,0,33,2013
"PPW1324","B2","QUEDEC",4,2,0,6,2013
"PPW1324","B1","QUEDEC",1,0,0,1,2013
"PPW1324","C1","QUEDEC",1,0,0,1,2013
"PPW1324","C1","UMBCAL",0,1,0,1,2013
"PPW1324","C1","PSEMEN",0,1,0,1,2013
"PPW1324","C2","QUEDEC",6,6,0,12,2013
"PPW1324","C3","QUEDEC",6,5,0,11,2013
"PPW1324","C4","QUEDEC",1,0,0,1,2013
"PPW1324","C4","QUEDEC",2,2,0,4,2013
"PPW1324","D4","ARBMEN",0,3,0,3,2013
"PPW1324","D4","QUEDEC",2,0,0,2,2013
"PPW1324","D3","QUEDEC",1,3,0,4,2013
"PPW1324","D3","QUEDEC",2,0,0,2,2013
"PPW1324","D3","ARBMEN",0,1,0,1,2013
"PPW1324","D2","QUEDEC",1,0,0,1,2013
"PPW1324","D1","UMBCAL",0,3,0,3,2013
"PPW1324","D1","ARBMEN",0,1,0,1,2013
"PPW1324","D1","QUEAGR",1,0,0,1,2013
"PPW1325","A1","ARCMAN",0,3,0,3,2013
"PPW1325","A1","HETARB",0,1,0,1,2013
"PPW1325","A1","QUEDEC",2,0,0,2,2013
"PPW1325","A1","PSEMEN",0,1,0,1,2013
"PPW1325","A2","UMBCAL",0,2,0,2,2013
"PPW1325","A2","PSEMEN",0,1,0,1,2013
"PPW1325","A2","QUEAGR",0,1,0,1,2013
"PPW1325","A3","UMBCAL",0,1,0,1,2013
"PPW1325","A3","QUEDEC",1,0,0,1,2013
"PPW1325","A4","QUEDEC",4,2,0,6,2013
"PPW1325","A4","ARCMAN",2,2,0,4,2013
"PPW1325","B4","QUEDEC",1,0,0,1,2013
"PPW1325","B4","QUEDEC",2,1,0,3,2013
"PPW1325","B4","ARCMAN",0,1,0,1,2013
"PPW1325","B3","QUEAGR",3,1,0,4,2013
"PPW1325","B3","QUEDEC",2,0,0,2,2013
"PPW1325","B3","ARBMEN",1,1,0,2,2013
"PPW1325","B2","ARBMEN",0,2,0,2,2013
"PPW1325","B2","QUEDEC",3,0,0,3,2013
"PPW1325","B2","QUEAGR",4,0,0,4,2013
"PPW1325","B1","QUEDEC",4,0,0,4,2013
"PPW1325","C1","QUEDEC",7,0,0,7,2013
"PPW1325","C2","QUEAGR",1,1,0,2,2013
"PPW1325","C2","QUEDEC",3,0,0,3,2013
"PPW1325","B2","ARCMAN",0,1,0,1,2013
"PPW1325","C3","QUEDEC",6,0,0,6,2013
"PPW1325","C3","HETARB",0,1,0,1,2013
"PPW1325","C4","ARCMAN",0,1,0,1,2013
"PPW1325","C4","PSEMEN",0,1,0,1,2013
"PPW1325","D4","ARBMEN",1,0,0,1,2013
"PPW1325","D3","QUEDEC",3,0,0,3,2013
"PPW1325","D2","HETARB",2,0,0,2,2013
"PPW1325","D2","QUEDEC",35,0,0,35,2013
"PPW1325","D2","QUEAGR",0,2,0,2,2013
"PPW1325","D1","QUEDEC",22,2,0,24,2013
"PPW1325","D1","ARBMEN",0,1,0,1,2013
"PPW1325","D1","PSEMEN",1,0,0,1,2013
"PPW1325","D1","HETARB",1,0,0,1,2013
"PPW1325","D1","QUEAGR",1,0,0,1,2013
"PPW1325","D1","UMBCAL",0,1,0,1,2013
"PPW1326","A1","UMBCAL",0,6,0,6,2013
"PPW1326","A1","QUEDEC",0,1,0,1,2013
"PPW1326","A2","UMBCAL",0,11,0,11,2013
"PPW1326","A2","QUEDEC",0,1,0,1,2013
"PPW1326","A3","UMBCAL",3,10,0,13,2013
"PPW1326","A3","PSEMEN",0,1,0,1,2013
"PPW1326","A4","UMBCAL",0,12,0,12,2013
"PPW1326","A4","QUEDEC",1,0,0,1,2013
"PPW1326","B4","UMBCAL",1,11,0,12,2013
"PPW1326","B4","QUEDEC",0,1,0,1,2013
"PPW1326","B3","UMBCAL",4,12,0,16,2013
"PPW1326","B2","UMBCAL",0,16,0,16,2013
"PPW1326","B1","UMBCAL",0,7,0,7,2013
"PPW1326","C1","UMBCAL",0,12,1,12,2013
"PPW1326","C2","QUEDEC",0,8,0,8,2013
"PPW1326","C2","QUEDEC",0,1,0,1,2013
"PPW1326","C2","QUEAGR",0,1,0,1,2013
"PPW1326","C3","UMBCAL",0,13,0,13,2013
"PPW1326","A2","PSEMEN",0,0,1,0,2013
"PPW1326","B3","PSEMEN",0,1,0,1,2013
"PPW1326","C4","UMBCAL",0,15,0,15,2013
"PPW1326","D4","UMBCAL",0,5,0,5,2013
"PPW1326","D3","UMBCAL",0,12,0,12,2013
"PPW1326","D2","UMBCAL",0,6,0,6,2013
"PPW1326","D1","UMBCAL",2,12,0,14,2013
"PPW1327","A2","QUEBER",0,5,0,5,2013
"PPW1327","A2","QUEAGR",0,1,0,1,2013
"PPW1327","A2","PSEMEN",0,1,0,1,2013
"PPW1327","A3","UMBCAL",0,3,0,3,2013
"PPW1327","A3","HETARB",0,1,0,1,2013
"PPW1327","A3","QUEDEC",0,1,0,1,2013
"PPW1327","A4","QUEBER",0,3,0,3,2013
"PPW1327","A4","UMBCAL",0,1,0,1,2013
"PPW1327","A4","PSEMEN",0,1,0,1,2013
"PPW1327","B4","QUEBER",0,2,0,2,2013
"PPW1327","B3","QUEBER",1,5,0,6,2013
"PPW1327","B3","HETARB",0,1,0,1,2013
"PPW1327","B2","HETARB",0,2,0,2,2013
"PPW1327","B2","UNK21",0,1,0,1,2013
"PPW1327","B2","QUEBER",0,11,0,11,2013
"PPW1327","B2","ARBMEN",0,1,0,1,2013
"PPW1327","B1","UMBCAL",0,1,0,1,2013
"PPW1327","B1","QUEBER",1,3,0,4,2013
"PPW1327","B1","QUEAGR",0,1,0,1,2013
"PPW1327","B1","UMBCAL",0,1,0,1,2013
"PPW1327","C1","HETARB",3,2,0,5,2013
"PPW1327","C1","PSEMEN",0,1,0,1,2013
"PPW1327","C1","QUEBER",1,1,0,2,2013
"PPW1327","C1","QUEDEC",0,1,0,1,2013
"PPW1327","C1","QUEAGR",1,0,0,1,2013
"PPW1327","C2","HETARB",0,3,0,3,2013
"PPW1327","C2","QUEBER",1,2,0,3,2013
"PPW1327","C4","QUEAGR",0,1,0,1,2013
"PPW1327","C4","QUEBER",0,1,0,1,2013
"PPW1327","D4","PSEMEN",0,3,0,3,2013
"PPW1327","D4","QUEDEC",0,2,0,2,2013
"PPW1327","D3","PSEMEN",0,0,0,0,2013
"PPW1327","D3","UMBCAL",0,0,0,0,2013
"PPW1327","D3","HETARB",0,0,0,0,2013
"PPW1327","D3","QUEBER",0,0,0,0,2013
"PPW1327","D2","PSEMEN",0,0,0,0,2013
"PPW1327","D2","QUEBER",0,0,0,0,2013
"PPW1327","D1","PSEMEN",0,0,0,0,2013
"PPW1327","D1","QUEBER",0,0,0,0,2013
"PPW1327","D1","HETARB",0,0,0,0,2013
"PPW1327","Q",NA,0,0,0,0,2013
"PPW1328","A1","PSEMEN",3,22,0,25,2013
"PPW1328","A1","FRACAL",4,1,0,5,2013
"PPW1328","A1","QUEAGR",3,1,0,4,2013
"PPW1328","A2","UMBCAL",1,0,0,1,2013
"PPW1328","A2","PSEMEN",2,48,0,50,2013
"PPW1328","A2","FRACAL",5,2,0,7,2013
"PPW1328","A2","QUEAGR",5,5,0,10,2013
"PPW1328","A3","PSEMEN",2,19,0,21,2013
"PPW1328","A3","UMBCAL",1,1,0,2,2013
"PPW1328","A3","QUEAGR",0,1,0,1,2013
"PPW1328","A3","FRACAL",8,8,0,16,2013
"PPW1328","A4","FRACAL",7,10,0,17,2013
"PPW1328","A4","PSEMEN",1,9,0,10,2013
"PPW1328","A4","UMBCAL",0,2,0,2,2013
"PPW1328","A4","QUEAGR",0,1,0,1,2013
"PPW1328","B4","PSEMEN",1,10,0,11,2013
"PPW1328","B4","FRACAL",1,5,0,6,2013
"PPW1328","B4","QUEAGR",0,8,0,8,2013
"PPW1328","B3","UMBCAL",1,0,0,1,2013
"PPW1328","B3","PSEMEN",0,30,0,30,2013
"PPW1328","B3","QUEAGR",1,2,0,3,2013
"PPW1328","B3","FRACAL",2,7,0,9,2013
"PPW1328","B2","PSEMEN",2,19,0,21,2013
"PPW1328","B2","QUEAGR",0,1,0,1,2013
"PPW1328","B1","PSEMEN",0,24,0,24,2013
"PPW1328","B1","FRACAL",1,0,0,1,2013
"PPW1328","B1","QUEAGR",2,1,0,3,2013
"PPW1328","B1","UMBCAL",0,1,0,1,2013
"PPW1328","C1","PSEMEN",2,39,0,41,2013
"PPW1328","C1","QUEAGR",1,0,0,1,2013
"PPW1328","C1","FRACAL",0,1,0,1,2013
"PPW1328","C2","PSEMEN",1,40,0,41,2013
"PPW1328","C2","FRACAL",2,7,0,9,2013
"PPW1328","C2","QUEAGR",1,0,0,1,2013
"PPW1328","C3","PSEMEN",0,33,0,33,2013
"PPW1328","C3","FRACAL",38,19,0,57,2013
"PPW1328","C3","QUEAGR",1,1,0,2,2013
"PPW1328","C3","UMBCAL",0,4,0,4,2013
"PPW1328","C3","HETARB",0,1,0,1,2013
"PPW1328","C4","PSEMEN",0,14,0,14,2013
"PPW1328","C4","UMBCAL",3,3,0,6,2013
"PPW1328","C4","FRACAL",6,7,0,13,2013
"PPW1328","C4","QUEAGR",2,5,0,7,2013
"PPW1328","C4","HETARB",2,2,0,4,2013
"PPW1328","D1","PSEMEN",1,18,0,19,2013
"PPW1328","D1","FRACAL",7,3,0,10,2013
"PPW1328","D1","HETARB",0,2,0,2,2013
"PPW1328","D1","QUEAGR",0,3,0,3,2013
"PPW1328","D1","UMBCAL",0,1,0,1,2013
"PPW1328","D2","PSEMEN",0,14,0,14,2013
"PPW1328","D2","FRACAL",4,7,0,11,2013
"PPW1328","D2","QUEAGR",0,1,0,1,2013
"PPW1328","D2","UMBCAL",1,2,0,3,2013
"PPW1328","D2","HETARB",1,1,0,2,2013
"PPW1328","D3","UMBCAL",0,2,0,2,2013
"PPW1328","D3","FRACAL",3,9,0,12,2013
"PPW1328","D3","PSEMEN",2,11,0,13,2013
"PPW1328","D3","QUEAGR",1,4,0,5,2013
"PPW1328","D4","FRACAL",0,3,0,3,2013
"PPW1328","D4","QUEAGR",2,4,0,6,2013
"PPW1328","D4","PSEMEN",0,18,0,18,2013
"PPW1328","D4","QUEDEC",1,0,0,1,2013
"PPW1328","D4","UMBCAL",1,0,0,1,2013
"PPW1329","A3","UMBCAL",0,1,0,1,2013
"PPW1329","A4","QUEAGR",1,0,0,1,2013
"PPW1329","B2","UMBCAL",1,0,0,1,2013
"PPW1329","B2","QUEAGR",0,1,0,1,2013
"PPW1329","A3","QUEAGR",0,1,0,1,2013
"PPW1329","B1","QUEAGR",1,0,0,1,2013
"PPW1329","C2","QUEAGR",2,0,0,2,2013
"PPW1329","C3","QUEDEC",0,1,0,1,2013
"PPW1329","C3","UMBCAL",0,2,0,2,2013
"PPW1329","C4","UMBCAL",0,2,0,2,2013
"PPW1329","C4","QUEAGR",1,0,0,1,2013
"PPW1329","D4","QUEDEC",1,1,0,2,2013
"PPW1329","D4","UMBCAL",0,3,0,3,2013
"PPW1329","D3","PSEMEN",0,1,0,1,2013
"PPW1329","D2","UMBCAL",0,1,0,1,2013
"PPW1329","D1","QUEAGR",2,2,0,4,2013
"PPW1329","D1","PSEMEN",0,1,0,1,2013
"PPW1330","A1","UMBCAL",0,10,0,10,2013
"PPW1330","A1","HETARB",0,1,0,1,2013
"PPW1330","A1","PSEMEN",0,1,0,1,2013
"PPW1330","A1","QUEAGR",0,1,0,1,2013
"PPW1330","A2","UMBCAL",0,8,0,8,2013
"PPW1330","A2","FRACAL",0,2,0,2,2013
"PPW1330","A2","QUEAGR",0,1,0,1,2013
"PPW1330","A3","UMBCAL",2,10,0,12,2013
"PPW1330","A3","FRACAL",0,1,0,1,2013
"PPW1330","A3","QUEAGR",0,1,0,1,2013
"PPW1330","A4","UMBCAL",1,27,0,28,2013
"PPW1330","A4","PSEMEN",0,2,0,2,2013
"PPW1330","A4","QUEAGR",0,2,0,2,2013
"PPW1330","B4","UMBCAL",2,4,0,6,2013
"PPW1330","B4","FRACAL",0,1,0,1,2013
"PPW1330","B3","UMBCAL",0,8,0,8,2013
"PPW1330","B3","QUEAGR",0,1,0,1,2013
"PPW1330","B2","QUEDEC",1,5,0,6,2013
"PPW1330","B2","UMBCAL",0,7,0,7,2013
"PPW1330","B2","HETARB",0,1,0,1,2013
"PPW1330","B2","QUEAGR",0,1,0,1,2013
"PPW1330","B1","PSEMEN",0,1,0,1,2013
"PPW1330","B1","QUEDEC",0,1,0,1,2013
"PPW1330","B1","QUEAGR",0,4,0,4,2013
"PPW1330","B1","FRACAL",0,2,0,2,2013
"PPW1330","B1","UMBCAL",0,3,0,3,2013
"PPW1330","C1","UMBCAL",0,8,0,8,2013
"PPW1330","C1","QUEAGR",0,1,0,1,2013
"PPW1330","C1","HETARB",0,2,0,2,2013
"PPW1330","C2","UMBCAL",0,1,0,1,2013
"PPW1330","C2","HETARB",0,1,0,1,2013
"PPW1330","C3","UMBCAL",0,3,0,3,2013
"PPW1330","C3","QUEAGR",0,2,1,2,2013
"PPW1330","C3","HETARB",0,1,0,1,2013
"PPW1330","C4","QUEAGR",0,1,0,1,2013
"PPW1330","C4","QUEDEC",0,4,0,4,2013
"PPW1330","C4","AMOCAL",0,5,0,5,2013
"PPW1330","D4","UMBCAL",1,5,0,6,2013
"PPW1330","D4","QUEAGR",0,1,0,1,2013
"PPW1330","D3","UMBCAL",0,1,0,1,2013
"PPW1330","D3","QUEAGR",0,1,0,1,2013
"PPW1330","D2","UMBCAL",0,2,0,2,2013
"PPW1330","D2","QUEAGR",0,3,0,3,2013
"PPW1330","D1","UMBCAL",0,2,0,2,2013
"PPW1330","D1","ARCMAN",0,1,0,1,2013
"PPW1330","D1","QUEAGR",0,3,0,3,2013
"PPW1331","A1","UMBCAL",0,1,0,1,2013
"PPW1331","A2","UMBCAL",0,1,0,1,2013
"PPW1331","A3","UMBCAL",0,1,0,1,2013
"PPW1331","B4","UMBCAL",0,1,0,1,2013
"PPW1331","A3","PSEMEN",1,0,0,1,2013
"PPW1331","B3","UMBCAL",0,1,0,1,2013
"PPW1331","B2","UMBCAL",0,1,0,1,2013
"PPW1331","B1","UMBCAL",0,6,0,6,2013
"PPW1331","B1","ARBMEN",0,1,0,1,2013
"PPW1331","C1","UMBCAL",0,1,0,1,2013
"PPW1331","C2","HETARB",0,3,0,3,2013
"PPW1331","C2","QUEAGR",0,1,0,1,2013
"PPW1331","C2","ARBMEN",0,0,1,0,2013
"PPW1331","C3","UMBCAL",0,2,0,2,2013
"PPW1331","C4","UMBCAL",0,1,0,1,2013
"PPW1331","D4","UMBCAL",0,1,0,1,2013
"PPW1331","D3","UMBCAL",0,3,0,3,2013
"PPW1331","D1","UMBCAL",0,1,0,1,2013
"PPW1331","D1","HETARB",0,2,0,2,2013
"PPW1332","A1","UMBCAL",0,1,0,1,2013
"PPW1332","A2","UMBCAL",1,1,0,2,2013
"PPW1332","A3","UMBCAL",2,1,0,3,2013
"PPW1332","B4","UMBCAL",1,2,0,3,2013
"PPW1332","B3","AESCAL",0,2,0,2,2013
"PPW1332","B3","UMBCAL",1,2,0,3,2013
"PPW1332","B2","UMBCAL",3,1,0,4,2013
"PPW1332","B2","AESCAL",1,3,0,4,2013
"PPW1332","B1","UMBCAL",0,1,0,1,2013
"PPW1332","B1","AESCAL",0,1,0,1,2013
"PPW1332","C1","UMBCAL",0,7,0,7,2013
"PPW1332","C1","AESCAL",0,1,0,1,2013
"PPW1332","C2","UMBCAL",1,3,0,4,2013
"PPW1332","C2","AESCAL",0,3,0,3,2013
"PPW1332","C3","AESCAL",0,1,0,1,2013
"PPW1332","C4","UMBCAL",1,4,0,5,2013
"PPW1332","D4","UMBCAL",0,2,0,2,2013
"PPW1332","D3","UMBCAL",0,4,0,4,2013
"PPW1332","D2","UMBCAL",0,4,0,4,2013
"PPW1332","D1","UMBCAL",4,7,0,11,2013
"PPW1332","D3","AESCAL",0,1,0,1,2013
"PPW1333","A1","UMBCAL",12,21,0,33,2013
"PPW1333","A1","QUEAGR",0,1,0,1,2013
"PPW1333","A2","UMBCAL",21,43,0,64,2013
"PPW1333","A2","QUEAGR",1,0,0,1,2013
"PPW1333","A3","UMBCAL",6,15,0,21,2013
"PPW1333","A3","QUEDEC",1,1,0,2,2013
"PPW1333","A4","QUEDEC",1,0,0,1,2013
"PPW1333","A4","QUEAGR",0,1,0,1,2013
"PPW1333","A4","UMBCAL",0,1,0,1,2013
"PPW1333","B4","UMBCAL",1,15,0,16,2013
"PPW1333","B4","QUEAGR",0,1,0,1,2013
"PPW1333","B4","QUEDEC",3,0,0,3,2013
"PPW1333","B3","UMBCAL",2,31,0,33,2013
"PPW1333","A2","PSEMEN",0,0,1,0,2013
"PPW1333","B2","UMBCAL",9,35,0,44,2013
"PPW1333","B2","QUEAGR",1,0,0,1,2013
"PPW1333","B1","UMBCAL",10,24,0,34,2013
"PPW1333","C1","UMBCAL",7,17,0,24,2013
"PPW1333","C1","QUEDEC",2,0,0,2,2013
"PPW1333","C1","QUEAGR",1,0,0,1,2013
"PPW1333","C1","AESCAL",0,1,0,1,2013
"PPW1333","C2","UMBCAL",9,18,0,27,2013
"PPW1333","C2","QUEDEC",4,0,0,4,2013
"PPW1333","C2","QUEAGR",2,0,0,2,2013
"PPW1333","C3","UMBCAL",14,24,0,38,2013
"PPW1333","C4","UMBCAL",4,9,0,13,2013
"PPW1333","C4","QUEDEC",6,2,0,8,2013
"PPW1333","D4","UMBCAL",2,20,0,22,2013
"PPW1333","D4","QUEDEC",2,1,0,3,2013
"PPW1333","D4","HETARB",1,0,0,1,2013
"PPW1333","D4","QUEAGR",1,1,0,2,2013
"PPW1333","D3","UMBCAL",4,21,0,25,2013
"PPW1333","D3","QUEDEC",2,0,0,2,2013
"PPW1333","D2","QUEDEC",4,2,0,6,2013
"PPW1333","D2","UMBCAL",5,20,0,25,2013
"PPW1333","D1","UMBCAL",1,4,0,5,2013
"PPW1333","D1","QUEDEC",3,1,0,4,2013
"PPW1334","A1","AESCAL",0,1,1,1,2013
"PPW1334","B1","AESCAL",0,1,0,1,2013
"PPW1334","B2","AESCAL",0,1,0,1,2013
"PPW1334","A2","AESCAL",0,1,0,1,2013
"PPW1334","A2","UMBCAL",0,1,0,1,2013
"PPW1334","A3","AESCAL",0,2,0,2,2013
"PPW1334","A4","AESCAL",0,3,0,3,2013
"PPW1334","B3","AESCAL",0,9,2,9,2013
"PPW1334","B4","AESCAL",2,7,0,9,2013
"PPW1334","C4","AESCAL",0,3,0,3,2013
"PPW1334","C4","UMBCAL",0,1,0,1,2013
"PPW1334","B2","QUEAGR",0,1,0,1,2013
"PPW1334","D3","UMBCAL",0,1,0,1,2013
"PPW1334","D3","QUEDEC",0,3,0,3,2013
"PPW1334","D3","AESCAL",0,1,0,1,2013
"PPW1334","B1","QUEDEC",0,1,0,1,2013
"PPW1334","D2","AESCAL",3,11,1,14,2013
"PPW1334","C2","AESCAL",0,5,2,5,2013
"PPW1334","C1","QUEDEC",0,2,0,2,2013
"PPW1334","C1","AESCAL",1,5,2,6,2013
"PPW1334","D1","AESCAL",2,9,2,11,2013
"PPW1335","A1","UMBCAL",2,50,0,52,2013
"PPW1335","A2","QUEDEC",2,1,0,3,2013
"PPW1335","A2","UMBCAL",0,23,0,23,2013
"PPW1335","A3","UMBCAL",1,4,0,5,2013
"PPW1335","A4","UMBCAL",0,3,0,3,2013
"PPW1335","B4","UMBCAL",1,4,0,5,2013
"PPW1335","B3","UMBCAL",0,6,0,6,2013
"PPW1335","B2","QUEDEC",0,0,1,0,2013
"PPW1335","B2","UMBCAL",0,27,0,27,2013
"PPW1335","B1","UMBCAL",3,49,0,52,2013
"PPW1335","C1","UMBCAL",1,33,0,34,2013
"PPW1335","C2","UMBCAL",1,14,0,15,2013
"PPW1335","C3","UMBCAL",0,4,0,4,2013
"PPW1335","C4","UMBCAL",0,6,0,6,2013
"PPW1335","D4","UMBCAL",1,24,0,25,2013
"PPW1335","D3","UMBCAL",2,11,0,13,2013
"PPW1335","D2","UMBCAL",0,16,0,16,2013
"PPW1335","D1","UMBCAL",0,20,0,20,2013
"PPW1335","D1","AESCAL",1,0,0,1,2013
"PPW1336","A1","QUEDEC",18,1,0,19,2013
"PPW1336","A2","QUEDEC",4,0,0,4,2013
"PPW1336","A2","UMBCAL",0,3,0,3,2013
"PPW1336","A3","UMBCAL",0,1,0,1,2013
"PPW1336","A3","QUEDEC",2,1,0,3,2013
"PPW1336","A4","UMBCAL",1,1,0,2,2013
"PPW1336","B4","QUEDEC",5,0,0,5,2013
"PPW1336","B4","UMBCAL",0,1,0,1,2013
"PPW1336","B3","QUEAGR",0,1,0,1,2013
"PPW1336","B3","UMBCAL",0,1,0,1,2013
"PPW1336","B2","QUEDEC",1,0,0,1,2013
"PPW1336","B2","UMBCAL",1,0,0,1,2013
"PPW1336","B1","QUEDEC",5,0,0,5,2013
"PPW1336","B1","UMBCAL",0,9,0,9,2013
"PPW1336","B1","QUEAGR",0,1,0,1,2013
"PPW1336","C1","UMBCAL",0,3,0,3,2013
"PPW1336","C1","QUEDEC",1,0,0,1,2013
"PPW1336","C2","UMBCAL",1,3,0,4,2013
"PPW1336","C3","QUEAGR",0,1,0,1,2013
"PPW1336","C3","UMBCAL",2,2,0,4,2013
"PPW1336","C4","UMBCAL",0,0,0,0,2013
"PPW1336","C4","QUEDEC",9,0,0,9,2013
"PPW1336","D4","QUEDEC",3,0,0,3,2013
"PPW1336","D4","UMBCAL",0,1,0,1,2013
"PPW1336","D3","UMBCAL",1,1,0,2,2013
"PPW1336","D3","QUEDEC",1,0,0,1,2013
"PPW1336","D3","QUEAGR",1,0,0,1,2013
"PPW1336","D2","QUEDEC",5,1,0,6,2013
"PPW1336","D2","UMBCAL",1,1,0,2,2013
"PPW1336","D1","QUEDEC",1,2,0,3,2013
"PPW1336","D1","UMBCAL",1,4,0,5,2013
"PPW1337","A1","ARBMEN",0,4,0,4,2013
"PPW1337","A3","UMBCAL",0,1,0,1,2013
"PPW1337","A3","ARBMEN",0,1,0,1,2013
"PPW1337","B4","ARBMEN",0,5,0,5,2013
"PPW1337","B3","ARBMEN",0,1,0,1,2013
"PPW1337","B3","UMBCAL",0,1,0,1,2013
"PPW1337","B3","QUEAGR",0,1,0,1,2013
"PPW1337","B2","QUEDEC",0,1,0,1,2013
"PPW1337","B1","UMBCAL",0,2,0,2,2013
"PPW1337","B1","AESCAL",0,1,0,1,2013
"PPW1337","B1","QUEDEC",0,1,0,1,2013
"PPW1337","B1","QUEAGR",0,2,0,2,2013
"PPW1337","C1","UMBCAL",1,1,0,2,2013
"PPW1337","C1","QUEDEC",3,0,0,3,2013
"PPW1337","C2","ARBMEN",0,6,0,6,2013
"PPW1337","C2","UMBCAL",0,4,0,4,2013
"PPW1337","C2","AESCAL",0,1,0,1,2013
"PPW1337","C2","QUEAGR",0,1,0,1,2013
"PPW1337","C3","UMBCAL",0,2,0,2,2013
"PPW1337","C3","QUEAGR",0,1,0,1,2013
"PPW1337","C3","ARBMEN",0,3,0,3,2013
"PPW1337","C4","PSEMEN",0,3,0,3,2013
"PPW1337","C4","ARBMEN",0,4,0,4,2013
"PPW1337","C4","QUEDEC",0,1,0,1,2013
"PPW1337","C4","QUEAGR",0,2,0,2,2013
"PPW1337","D4","ARBMEN",0,1,0,1,2013
"PPW1337","D4","PSEMEN",0,1,0,1,2013
"PPW1337","D4","QUEAGR",0,2,0,2,2013
"PPW1337","D3","PSEMEN",0,2,0,2,2013
"PPW1337","D3","QUEAGR",0,2,0,2,2013
"PPW1337","D2","PSEMEN",0,1,0,1,2013
"PPW1337","D2","ARBMEN",1,4,0,5,2013
"PPW1337","D1","UMBCAL",1,0,0,1,2013
"PPW1338","A1","PSEMEN",1,3,0,4,2013
"PPW1338","A1","UMBCAL",1,1,0,2,2013
"PPW1338","A2","UMBCAL",1,4,0,5,2013
"PPW1338","A2","PSEMEN",0,1,0,1,2013
"PPW1338","A3","UMBCAL",0,3,0,3,2013
"PPW1338","A4","UMBCAL",3,6,0,9,2013
"PPW1338","A4","QUEAGR",2,2,0,4,2013
"PPW1338","B4","UMBCAL",1,4,0,5,2013
"PPW1338","B3","UMBCAL",1,1,0,2,2013
"PPW1338","B1","UMBCAL",0,2,0,2,2013
"PPW1338","C1","UMBCAL",1,0,0,1,2013
"PPW1338","C1","QUEAGR",1,0,0,1,2013
"PPW1338","C2","QUEAGR",3,0,0,3,2013
"PPW1338","C2","PSEMEN",0,1,0,1,2013
"PPW1338","C2","UMBCAL",0,2,0,2,2013
"PPW1338","C4","PSEMEN",0,1,0,1,2013
"PPW1338","C4","UMBCAL",1,0,0,1,2013
"PPW1338","D4","PSEMEN",1,0,0,1,2013
"PPW1338","D3","PSEMEN",0,1,0,1,2013
"PPW1338","D2","UMBCAL",0,4,0,4,2013
"PPW1338","D1","UMBCAL",0,6,0,6,2013
"PPW1339","D1","QUEDEC",1,0,0,1,2013
"PPW1339","D1","UMBCAL",0,5,0,5,2013
"PPW1339","D1","QUEAGR",0,5,0,5,2013
"PPW1339","D2","UMBCAL",0,3,0,3,2013
"PPW1339","D2","QUEAGR",0,3,0,3,2013
"PPW1339","D3","QUEAGR",1,1,0,2,2013
"PPW1339","C4","QUEAGR",1,3,0,4,2013
"PPW1339","C4","UMBCAL",1,3,0,4,2013
"PPW1339","C4","ARBMEN",0,2,0,2,2013
"PPW1339","C3","QUEAGR",2,1,0,3,2013
"PPW1339","C3","UMBCAL",0,4,0,4,2013
"PPW1339","C3","PSEMEN",0,1,0,1,2013
"PPW1339","C2","QUEAGR",0,1,0,1,2013
"PPW1339","C2","UMBCAL",0,2,0,2,2013
"PPW1339","C1","QUEAGR",2,5,0,7,2013
"PPW1339","C1","UMBCAL",2,4,0,6,2013
"PPW1339","B1","QUEAGR",0,3,0,3,2013
"PPW1339","B1","UMBCAL",0,2,0,2,2013
"PPW1339","B2","QUEAGR",2,3,0,5,2013
"PPW1339","B2","UMBCAL",0,3,0,3,2013
"PPW1339","B3","QUEAGR",1,5,0,6,2013
"PPW1339","B3","UMBCAL",0,2,0,2,2013
"PPW1339","B4","QUEAGR",0,2,0,2,2013
"PPW1339","B4","HETARB",0,1,0,1,2013
"PPW1339","B4","UMBCAL",0,2,0,2,2013
"PPW1339","B4","QUEDEC",0,2,0,2,2013
"PPW1339","A4","UMBCAL",0,1,0,1,2013
"PPW1339","A3","ARCMAN",0,1,0,1,2013
"PPW1339","A3","UMBCAL",0,2,0,2,2013
"PPW1339","A2","QUEAGR",1,0,0,1,2013
"PPW1339","A2","UMBCAL",0,1,0,1,2013
"PPW1339","A1","UMBCAL",1,0,0,1,2013
"PPW1340","A1","UMBCAL",1,4,0,5,2013
"PPW1340","A1","PSEMEN",2,9,0,11,2013
"PPW1340","A2","PSEMEN",5,12,0,17,2013
"PPW1340","A2","UMBCAL",2,9,0,11,2013
"PPW1340","A2","QUEAGR",0,4,0,4,2013
"PPW1340","A3","PSEMEN",6,26,0,32,2013
"PPW1340","A3","UMBCAL",1,3,0,4,2013
"PPW1340","A3","QUEAGR",0,2,0,2,2013
"PPW1340","A4","PSEMEN",1,21,0,22,2013
"PPW1340","A4","UMBCAL",1,4,0,5,2013
"PPW1340","B4","UMBCAL",1,3,0,4,2013
"PPW1340","B4","PSEMEN",2,33,0,35,2013
"PPW1340","B4","QUEAGR",0,5,0,5,2013
"PPW1340","B4","BACPIL",0,1,0,1,2013
"PPW1340","B3","PSEMEN",4,27,0,31,2013
"PPW1340","B3","UMBCAL",2,9,0,11,2013
"PPW1340","B3","QUEAGR",0,6,0,6,2013
"PPW1340","B3","ARBMEN",0,1,0,1,2013
"PPW1340","B2","PSEMEN",5,10,0,15,2013
"PPW1340","B2","UMBCAL",0,14,0,14,2013
"PPW1340","B2","QUEAGR",0,1,0,1,2013
"PPW1340","B1","UMBCAL",0,5,0,5,2013
"PPW1340","B1","PSEMEN",2,1,0,3,2013
"PPW1340","B1","ARBMEN",2,0,0,2,2013
"PPW1340","C1","PSEMEN",6,0,0,6,2013
"PPW1340","C1","UMBCAL",0,4,0,4,2013
"PPW1340","C2","PSEMEN",12,4,0,16,2013
"PPW1340","C2","ARBMEN",1,0,0,1,2013
"PPW1340","C3","PSEMEN",5,37,0,42,2013
"PPW1340","C3","BACPIL",0,2,0,2,2013
"PPW1340","C3","UMBCAL",0,3,0,3,2013
"PPW1340","C4","PSEMEN",2,24,0,26,2013
"PPW1340","C4","ARBMEN",0,1,0,1,2013
"PPW1340","C4","BACPIL",1,1,0,2,2013
"PPW1340","C4","QUEAGR",0,1,0,1,2013
"PPW1340","C4","UMBCAL",0,2,0,2,2013
"PPW1340","D4","UMBCAL",0,2,0,2,2013
"PPW1340","D4","PSEMEN",3,12,0,15,2013
"PPW1340","D4","ARBMEN",2,0,0,2,2013
"PPW1340","D3","UMBCAL",1,4,0,5,2013
"PPW1340","D3","PSEMEN",7,41,0,48,2013
"PPW1340","D3","ARBMEN",3,0,0,3,2013
"PPW1340","D3","QUEAGR",0,1,0,1,2013
"PPW1340","D2","PSEMEN",8,9,1,17,2013
"PPW1340","D2","UMBCAL",0,8,0,8,2013
"PPW1340","D2","ARBMEN",0,1,0,1,2013
"PPW1340","D2","QUEAGR",0,1,0,1,2013
"PPW1340","D1","PSEMEN",7,2,1,9,2013
"PPW1340","D1","UMBCAL",1,5,1,6,2013
"PPW1341","A1","QUEAGR",0,2,0,2,2013
"PPW1341","A1","NOTDEN",1,1,0,2,2013
"PPW1341","A1","PSEMEN",1,1,0,2,2013
"PPW1341","A1","UMBCAL",0,1,0,1,2013
"PPW1341","A1","QUEDEC",1,0,0,1,2013
"PPW1341","A2","PSEMEN",3,1,0,4,2013
"PPW1341","A2","QUEAGR",1,1,0,2,2013
"PPW1341","A3","PSEMEN",3,5,0,8,2013
"PPW1341","A3","QUEAGR",1,1,0,2,2013
"PPW1341","A3","NOTDEN",0,1,0,1,2013
"PPW1341","A3","ARBMEN",1,0,0,1,2013
"PPW1341","A3","UMBCAL",0,1,0,1,2013
"PPW1341","A4","QUEAGR",0,1,0,1,2013
"PPW1341","A4","PSEMEN",2,5,1,7,2013
"PPW1341","A4","UMBCAL",0,1,0,1,2013
"PPW1341","B4","UMBCAL",0,1,0,1,2013
"PPW1341","B4","QUEAGR",1,1,0,2,2013
"PPW1341","B4","PSEMEN",0,1,0,1,2013
"PPW1341","B3","PSEMEN",1,1,0,2,2013
"PPW1341","B3","UMBCAL",0,1,0,1,2013
"PPW1341","B2","PSEMEN",2,0,0,2,2013
"PPW1341","B1","PSEMEN",2,7,0,9,2013
"PPW1341","B1","ARBMEN",1,0,0,1,2013
"PPW1341","C1","PSEMEN",5,18,0,23,2013
"PPW1341","C1","UMBCAL",0,1,0,1,2013
"PPW1341","C1","NOTDEN",0,2,0,2,2013
"PPW1341","C1","ARBMEN",3,0,0,3,2013
"PPW1341","C1","QUEAGR",0,1,0,1,2013
"PPW1341","C2","ARBMEN",1,0,0,1,2013
"PPW1341","C2","PSEMEN",1,1,0,2,2013
"PPW1341","C3","UMBCAL",0,1,0,1,2013
"PPW1341","C3","PSEMEN",0,2,0,2,2013
"PPW1341","C4","PSEMEN",4,2,2,6,2013
"PPW1341","C4","QUEAGR",0,1,0,1,2013
"PPW1341","C4","UMBCAL",1,0,0,1,2013
"PPW1341","D4","PSEMEN",0,2,0,2,2013
"PPW1341","D3","UMBCAL",0,2,0,2,2013
"PPW1341","D2","PSEMEN",1,9,1,10,2013
"PPW1341","D1","PSEMEN",3,48,1,51,2013
"PPW1341","D1","QUEAGR",1,6,0,7,2013
"PPW1341","D1","ARBMEN",1,0,0,1,2013
"PPW1341","D1","NOTDEN",0,2,0,2,2013
"PPW1342","A1","QUEAGR",0,3,0,3,2013
"PPW1342","A3","QUEAGR",0,1,0,1,2013
"PPW1342","A4","UMBCAL",0,1,0,1,2013
"PPW1342","A4","UNKN42",0,1,0,1,2013
"PPW1342","B2","UMBCAL",0,1,0,1,2013
"PPW1342","B1","UMBCAL",0,1,0,1,2013
"PPW1342","B1","QUEAGR",0,1,0,1,2013
"PPW1342","C1","UNKN42",0,1,0,1,2013
"PPW1342","C2","UMBCAL",0,1,0,1,2013
"PPW1342","C4","UMBCAL",0,1,0,1,2013
"PPW1342","D4","UMBCAL",0,1,0,1,2013
"PPW1342","D3","NOTDEN",0,1,0,1,2013
"PPW1343","A1","UMBCAL",0,10,0,10,2013
"PPW1343","A1","PSEMEN",0,2,0,2,2013
"PPW1343","A1","ARBMEN",0,2,0,2,2013
"PPW1343","A1","QUEAGR",0,1,0,1,2013
"PPW1343","A1","CEACUN",0,0,1,0,2013
"PPW1343","A2","UMBCAL",0,7,0,7,2013
"PPW1343","A3","UMBCAL",0,4,0,4,2013
"PPW1343","A3","QUEAGR",0,1,0,1,2013
"PPW1343","A3","PSEMEN",0,1,0,1,2013
"PPW1343","A4","ARBMEN",0,3,0,3,2013
"PPW1343","A4","QUEAGR",0,3,0,3,2013
"PPW1343","A4","UMBCAL",1,10,0,11,2013
"PPW1343","A4","HETARB",0,2,0,2,2013
"PPW1343","B4","QUEAGR",0,3,0,3,2013
"PPW1343","B4","UMBCAL",2,17,0,19,2013
"PPW1343","B4","ARBMEN",0,1,0,1,2013
"PPW1343","B4","HETARB",3,1,0,4,2013
"PPW1343","B4","PSEMEN",0,0,2,0,2013
"PPW1343","B3","PSEMEN",0,0,1,0,2013
"PPW1343","B3","QUEAGR",0,2,0,2,2013
"PPW1343","B3","UMBCAL",0,7,0,7,2013
"PPW1343","B2","ARBMEN",2,0,0,2,2013
"PPW1343","B2","UMBCAL",1,11,0,12,2013
"PPW1343","B2","PSEMEN",0,0,2,0,2013
"PPW1343","B1","UMBCAL",1,10,0,11,2013
"PPW1343","B1","ARBMEN",1,0,0,1,2013
"PPW1343","C1","UMBCAL",0,5,0,5,2013
"PPW1343","C1","QUEAGR",0,1,0,1,2013
"PPW1343","C1","ARBMEN",0,1,0,1,2013
"PPW1343","C2","UMBCAL",0,11,0,11,2013
"PPW1343","C2","QUEAGR",0,1,0,1,2013
"PPW1343","C3","UMBCAL",1,7,0,8,2013
"PPW1343","C4","UMBCAL",0,18,0,18,2013
"PPW1343","C4","QUEAGR",0,4,0,4,2013
"PPW1343","D4","ARBMEN",1,1,0,2,2013
"PPW1343","D4","UMBCAL",2,18,0,20,2013
"PPW1343","D4","QUEAGR",0,2,0,2,2013
"PPW1343","D4","PSEMEN",0,2,0,2,2013
"PPW1343","D3","UMBCAL",0,6,0,6,2013
"PPW1343","D3","QUEDEC",0,1,0,1,2013
"PPW1343","D2","UMBCAL",0,6,0,6,2013
"PPW1343","D2","QUEAGR",0,2,0,2,2013
"PPW1343","D1","UMBCAL",0,3,0,3,2013
"PPW1343","D1","ARBMEN",0,1,0,1,2013
"PPW1343","D1","PSEMEN",0,0,1,0,2013
"PPW1344","A1","QUEDEC",1,0,0,1,2013
"PPW1344","A2","QUEDEC",1,0,0,1,2013
"PPW1344","A2","QUEAGR",0,1,0,1,2013
"PPW1344","B2","QUEDEC",1,2,0,3,2013
"PPW1344","B2","QUEAGR",0,1,0,1,2013
"PPW1344","B1","QUEDEC",4,3,0,7,2013
"PPW1344","B1","QUEDEC",0,3,0,3,2013
"PPW1344","C1","QUEDEC",10,2,0,12,2013
"PPW1344","C1","QUEDEC",0,3,0,3,2013
"PPW1344","C2","QUEDEC",1,2,0,3,2013
"PPW1344","C2","QUEDEC",0,2,0,2,2013
"PPW1344","C4","QUEDEC",0,1,0,1,2013
"PPW1344","D4","QUEDEC",2,0,0,2,2013
"PPW1344","D3","QUEDEC",1,1,0,2,2013
"PPW1344","D2","QUEDEC",1,0,0,1,2013
"PPW1344","D1","QUEDEC",0,3,0,3,2013
"PPW1344","D1","QUEDEC",3,0,0,3,2013
"PPW1345","D4","PSEMEN",0,1,0,1,2013
"PPW1345","D4","UMBCAL",0,1,0,1,2013
"PPW1345","D2","HETARB",0,1,0,1,2013
"PPW1345","D1","HETARB",0,1,0,1,2013
"PPW1345","D1","UMBCAL",0,1,0,1,2013
"PPW1345","C1","HETARB",0,2,0,2,2013
"PPW1345","C1","UMBCAL",0,1,0,1,2013
"PPW1345","C1","QUEAGR",0,1,0,1,2013
"PPW1345","B1","HETARB",0,3,0,3,2013
"PPW1345","B1","UMBCAL",0,1,0,1,2013
"PPW1345","C4","PSEMEN",0,1,0,1,2013
"PPW1345","C4","HETARB",0,1,0,1,2013
"PPW1345","B4","UMBCAL",0,1,0,1,2013
"PPW1345","B4","QUEAGR",0,2,0,2,2013
"PPW1345","B3","QUEAGR",0,1,0,1,2013
"PPW1345","A2","UMBCAL",0,1,0,1,2013
"PPW1345","A2","HETARB",0,2,0,2,2013
"PPW1346","A2","UMBCAL",0,2,0,2,2013
"PPW1346","A3","UMBCAL",0,5,0,5,2013
"PPW1346","A3","UMBCAL",0,1,0,1,2013
"PPW1346","B2","UMBCAL",0,3,0,3,2013
"PPW1346","B2","QUEDEC",0,2,0,2,2013
"PPW1346","B1","HETARB",0,3,0,3,2013
"PPW1346","C1","AESCAL",0,1,0,1,2013
"PPW1346","C1","CEACUN",0,1,0,1,2013
"PPW1346","C3","AESCAL",0,1,0,1,2013
"PPW1346","C4","AESCAL",0,1,0,1,2013
"PPW1346","D4","AESCAL",0,1,0,1,2013
"PPW1346","D3","UMBCAL",0,1,0,1,2013
"PPW1346","D3","AESCAL",0,2,0,2,2013
"PPW1346","D1","AESCAL",0,6,0,6,2013
"PPW1346","D1","AMOCAL",0,1,0,1,2013
"PPW1346","D2","UMBCAL",0,1,0,1,2013
"PPW1347","A1","UMBCAL",0,2,0,2,2013
"PPW1347","A2","UMBCAL",1,1,0,2,2013
"PPW1347","A4","UMBCAL",0,2,0,2,2013
"PPW1347","B4","UMBCAL",0,3,0,3,2013
"PPW1347","B3","QUEAGR",0,1,0,1,2013
"PPW1347","B3","UMBCAL",0,3,0,3,2013
"PPW1347","B2","QUEAGR",0,2,0,2,2013
"PPW1347","B1","UMBCAL",0,4,0,4,2013
"PPW1347","C1","UMBCAL",0,4,0,4,2013
"PPW1347","C2","UMBCAL",0,1,0,1,2013
"PPW1347","C4","UMBCAL",0,1,0,1,2013
"PPW1347","D3","UMBCAL",0,1,0,1,2013
"PPW1347","D1","UMBCAL",0,3,0,3,2013
"PPW1348","A1","QUEAGR",0,2,0,2,2013
"PPW1348","A1","QUEDEC",0,1,0,1,2013
"PPW1348","A1","UMBCAL",0,1,0,1,2013
"PPW1348","A2","UMBCAL",0,1,0,1,2013
"PPW1348","A2","PSEMEN",0,1,0,1,2013
"PPW1348","A2","HETARB",0,1,0,1,2013
"PPW1348","A3","AMOCAL",0,1,0,1,2013
"PPW1348","A4","AMOCAL",0,1,0,1,2013
"PPW1348","A4","UMBCAL",0,2,0,2,2013
"PPW1348","B4","AMOCAL",0,4,0,4,2013
"PPW1348","B3","UMBCAL",1,2,0,3,2013
"PPW1348","B3","AMOCAL",0,1,0,1,2013
"PPW1348","B2","UMBCAL",0,2,0,2,2013
"PPW1348","B2","AMOCAL",0,15,0,15,2013
"PPW1348","B2","PSEMEN",0,0,1,0,2013
"PPW1348","B1","PSEMEN",0,1,0,1,2013
"PPW1348","B1","AMOCAL",0,1,0,1,2013
"PPW1348","C1","UMBCAL",0,2,0,2,2013
"PPW1348","C1","QUEAGR",0,1,0,1,2013
"PPW1348","C1","AMOCAL",0,1,0,1,2013
"PPW1348","C1","QUEDEC",0,2,0,2,2013
"PPW1348","C2","QUEDEC",0,1,0,1,2013
"PPW1348","C2","AMOCAL",0,2,0,2,2013
"PPW1348","C2","UMBCAL",0,1,0,1,2013
"PPW1348","C3","UMBCAL",0,4,0,4,2013
"PPW1348","C3","AMOCAL",0,2,0,2,2013
"PPW1348","C3","QUEDEC",0,1,0,1,2013
"PPW1348","C4","UMBCAL",0,2,0,2,2013
"PPW1348","C4","HETARB",0,1,0,1,2013
"PPW1348","C4","AMOCAL",0,2,0,2,2013
"PPW1348","D3","QUEDEC",0,1,0,1,2013
"PPW1348","D4","UMBCAL",0,1,0,1,2013
"PPW1348","D3","QUEDEC",0,3,0,3,2013
"PPW1348","D3","UMBCAL",0,5,0,5,2013
"PPW1348","D3","PSEMEN",1,1,0,2,2013
"PPW1348","D2","UMBCAL",0,3,0,3,2013
"PPW1348","D2","QUEAGR",0,1,0,1,2013
"PPW1348","D2","HETARB",0,1,0,1,2013
"PPW1349","A1","UMBCAL",1,7,0,8,2013
"PPW1349","A1","PSEMEN",1,2,0,3,2013
"PPW1349","A1","QUEAGR",0,1,0,1,2013
"PPW1349","A2","UMBCAL",0,4,0,4,2013
"PPW1349","A2","PSEMEN",1,4,0,5,2013
"PPW1349","A2","NOTDEN",0,1,0,1,2013
"PPW1349","A3","PSEMEN",2,9,0,11,2013
"PPW1349","A3","UMBCAL",1,0,0,1,2013
"PPW1349","A4","NOTDEN",0,2,0,2,2013
"PPW1349","A4","PSEMEN",1,5,0,6,2013
"PPW1349","A4","QUEAGR",1,0,0,1,2013
"PPW1349","B4","PSEMEN",0,4,0,4,2013
"PPW1349","B4","UMBCAL",0,1,0,1,2013
"PPW1349","B4","NOTDEN",0,1,0,1,2013
"PPW1349","B3","UMBCAL",0,2,0,2,2013
"PPW1349","B2","UMBCAL",0,2,0,2,2013
"PPW1349","B1","NOTDEN",0,1,0,1,2013
"PPW1349","B1","PSEMEN",0,2,0,2,2013
"PPW1349","B1","UMBCAL",0,2,0,2,2013
"PPW1349","C1","UMBCAL",0,2,0,2,2013
"PPW1349","C1","NOTDEN",0,1,0,1,2013
"PPW1349","C2","PSEMEN",1,1,0,2,2013
"PPW1349","C2","UMBCAL",0,1,0,1,2013
"PPW1349","C3","UMBCAL",0,3,0,3,2013
"PPW1349","C4","UMBCAL",0,2,0,2,2013
"PPW1349","C4","PSEMEN",1,2,0,3,2013
"PPW1349","C4","ARBMEN",1,0,0,1,2013
"PPW1349","D4","UMBCAL",0,3,0,3,2013
"PPW1349","D4","QUEDEC",0,1,0,1,2013
"PPW1349","D3","UMBCAL",1,2,0,3,2013
"PPW1349","D3","QUEDEC",0,1,0,1,2013
"PPW1349","D2","PSEMEN",0,2,0,2,2013
"PPW1349","D1","UMBCAL",0,1,0,1,2013
"PPW1349","D1","QUEDEC",1,0,0,1,2013
"PPW1349","D1","QUEDEC",0,1,0,1,2013
"PPW1350","A1","UMBCAL",0,1,0,1,2013
"PPW1350","A1","QUEDEC",0,1,0,1,2013
"PPW1350","A2","UMBCAL",0,1,0,1,2013
"PPW1350","A3","UMBCAL",0,1,0,1,2013
"PPW1350","A3","HETARB",0,1,0,1,2013
"PPW1350","A4","UMBCAL",0,3,0,3,2013
"PPW1350","B4","UMBCAL",0,1,0,1,2013
"PPW1350","B3","UMBCAL",0,2,0,2,2013
"PPW1350","B2","HETARB",0,1,0,1,2013
"PPW1350","B1","PSEMEN",1,1,0,2,2013
"PPW1350","B1","QUEDEC",1,0,0,1,2013
"PPW1350","B1","FRACAL",0,1,0,1,2013
"PPW1350","B1","AMOCAL",0,2,0,2,2013
"PPW1350","C1","QUEDEC",0,1,0,1,2013
"PPW1350","C1","AMOCAL",1,7,0,8,2013
"PPW1350","C1","PSEMEN",0,5,1,5,2013
"PPW1350","C2","AMOCAL",0,1,0,1,2013
"PPW1350","C2","PSEMEN",0,1,0,1,2013
"PPW1350","C2","QUEAGR",0,2,0,2,2013
"PPW1350","C3","UMBCAL",0,1,0,1,2013
"PPW1350","C3","QUEAGR",2,2,0,4,2013
"PPW1350","C3","AMOCAL",0,1,0,1,2013
"PPW1350","C4","QUEAGR",0,2,0,2,2013
"PPW1350","C4","UMBCAL",0,2,0,2,2013
"PPW1350","D4","UMBCAL",0,2,0,2,2013
"PPW1350","D4","QUEAGR",0,3,0,3,2013
"PPW1350","D4","AMOCAL",0,2,0,2,2013
"PPW1350","D3","QUEAGR",0,2,0,2,2013
"PPW1350","D3","AMOCAL",0,1,0,1,2013
"PPW1350","D3","UMBCAL",0,1,0,1,2013
"PPW1350","D2","AMOCAL",0,1,0,1,2013
"PPW1350","D2","QUEAGR",0,2,0,2,2013
"PPW1350","D1","QUEAGR",0,1,0,1,2013
"PPW1350","D1","FRACAL",1,0,0,1,2013
"PPW1350","D1","UMBCAL",0,1,0,1,2013
